R 800 600
NO ../resources/tile1.bmp
SO ../resources/tile2.bmp
WE ../resources/tile3.bmp
EA ../resources/tile4.bmp

S ../resources/vase.bmp
F 104, 128, 136
C 168, 152, 104

                          11111111111111111
                         1122000000000002211
                        110000000000000000011
                        100000000000000000001
                        100000000000000000001
                        100000000000000000001
                        100000000000000000001
                       11000000000000000000011
 1111111111111111111111100000000000000000000011111111111111111111111
112220000000000000000000000000000000000000000000000000000000000022211
100000000000000000000000000000000000000000000000000000000000000000001
100000000000000000000000000000000000000000000000000000000000000000001
100000000000000000000000000000000000000000000000000000000000000000001
100000000000000001111111000000000000000000000111111100000000000000001
100000000000000001111111000000000000000000000111111100000000000000001
100000000000000000211120000000000000000000000021112000000000000000001
100000000000000000011100000000000000000000000001110000000000000000001
100000000000000000000000000000000000000000000000000000000000000000001
100000000000000000000000000000000000000000000000000000000000000000001
100000000000000000000000000000000N00000000000000000000000000000000001
110000000000000000000000000000000000000000000000000000000000000000011
 111111111111111111111111111111111111111111111111111111111111111111
